fit - en forma
kaputt - roto, estropeado
komplett - completamente
herzlich - cordial, afectuosa, cariñosa
automatisch - automático
echt - de verdad, real, auténtico
erneut - nuevo
müde - cansado
relativ - relativo
international - internacional
eindeutig - obvio, inequívoco, indiscutible, indudable
selbstverständlich - evidente, lógico, obvio
selbst - por sí mismo 
verständ - comprensible
schöner - más bonito
regional - regional, local
wesentlich - esencial, fundamental
täglich - diariamente, a diario
jährlich - anualmente, al año
kürzlich - recientemente, hace poco
ruhig - tranquilo
leichter - más fácil, más liviano, más ligero
begeister - entusiasmado, impresionado
beliebt - apreciada, popular
verpflichtet - comprometido, obligado
original - original
persönlich - personal
plötzlich - de pronto, repentino -> plötzlich sehe ich dich - de pronto te veo
völlig - todo
fertig - cansado, rendido
jung - joven
zufrieden - contento, satisfecho
verfügbar - disponible
aktiv - activo
leicht - ligero
abhängig - adicto, dependiente
unabhängig - independiente	
knapp - escasa, justa
privat - en privado
stärker - más fuertes
bereit - listos
höher - más alto
wirklich - de verdad, realmente
allgemein - general/mente, común
individuell - individual
tatsächlich - efectivamente
verantwortlich, zuständig - responsable
länger - más largo
falsch - malo, falso
ausgezeichnet - excelente, magnífico
sinnvoll - sensato
sichtvar - visible
ähnlich - similar, parecida, semejante
notwendig - necesaria
extrem - extremadamente, extremo
offen - abierto
deutlich - claro, claramente
hilfreich - útil, beneficioso
unbekannt - desconocido
egal - da lo mismo, igual, no importa
wert - vale (valer)