Adjetivos en alemán:

stark - fuerte
schlecht - malo
gesund - sano
früh - temprano
frei - libre
teuer - caro
kostenlos - gratis
nützlich - util
einfach - sencillo
schön - bonito
kalt - frío
möglich - posible
wahrscheinlich - probable
alt - viejo
langsam - lento
genau - exacto
genug - suficiente
hoch - alto
wichtig - importante
richtig - correcto
schwer - pesado, difícil
toll - formidable, estupendo
voll - lleno
fest - fijo
kurz - corto, breve
weiß - blanco
fest - firme
jede - cada

Verbos:

brauchen - necesitar
ich mag - me gusta
wir mögen - nos gusta
sprechen - hablar
bezahlen - pagar	
schreiben - escribir
laufen - andar
helfen - ayudar
folgen - seguir
gehören - pertenecer
wissen - saber

Palabros:

gemeinsam - juntos


Kleidung - Ropa:

rock - falda (M)
kleid - vestido (N)
hemd - camisa (N)
mantel - abrigo (M)
hut - sombrero (M)
schuh - zapato (M)
hose - pantalón 
tasche - cartera, bolso, bolsillo (F)
jacke - chaqueta (F)
knopf - botón (M)
schmuck - joya (M)
leder - cuero (N)
größe - talla


Pronombres: Plurar y femenino añade e al final

mein - mi
dein - tu
sein
ihr
sein - su
unser - nuestro
euer - vuestro
ihr - su


niemand - nadie
jemand - alguien
jede - todo
welches - cual, que
viele - muchos
manche - algunos
alle - todos
man - se
beide - ambos


Familia:

mutter - madre
vater - padre
sohn - hijo
tochter - hija
großmutter - abuela
großvater - abuelo
schwester - hermana
bruder - hermano
geshwister - hermanos (hermanos y hermanas)
partner - pareja
partnerschaft - convivencia
eltern - padres
großeltern - abuelos
hochzeit - boda
beziehung - relación


Conjunciones: 

da - aquí, ahí
wie - que, cuán, cómo
wenn - cuando
oder - o
entweder - o
und - y
solange - mientras
sowie - tanto... como..., así como, además de
doch - si, pero
obwohl - aunque
aber - pero
sobald - tan pronto como, en cuanto
nachdem - después
sofern - siempre y cuando


Doméstico:

seife - jabón
regenschirm - paraguas
leiter - escalera (F)
teller - plato
bett - cama
bettbezug - ropa de cama
haushalt - hogar
öl - aceite
löffel - cuchara
gabel - tenedor
flasche - botella
wohnung - apartamento
glas - vaso
zahnpasta - pasta de dientes
zahnbürste - cepillo de dientes
schlüssel - llave
rasierer - máquina de afeitar (M)
batterie - batería
fenster - ventana
tisch - mesa
stuhl - silla
toilette - baño
bau - construcción
tor - portón (N)
tür - puerta
dach - techo
wand - pared
spiegel - espejo (M
spielzeug - juguete
treppe - escalera
lampe - lámpara
licht - luz
bad - baño
heizung - calefacción
keller - sótano
reinigung - limpieza
balkon - balcón
schlafzimmer - dormitorio
gerät - aparato (N)
haushaltsgeräte - electrodomésticos
werkzeug - herramienta
umzug - mudanza (M)
küche - cocina (F)
wohnort - lugar de residencia (M)
möbel - muebles
tasse - taza (F)
schüssel - cuenco

Preguntas:

was - que
warum - por qué, porqué
wieso - por qué (como es que)
wofür - para qué, para lo cual
wann - cuándo
wo - donde, por donde
wohin - adónde
wer - quién
wievil - cuánto
frage - pregunta (F)
antwort - respuesta (F)
worüber - de qué, sobre qué


Números:

erste - primer, primera
zweite - segundo
dritte - tercero
ein paar - algunas, una par de
zahl - número (F)
prozent - por ciento (N)
million - millón
hälfte - mitad (F)
etwas - algo, una parte
paar - pareja
maße - medida
summe - suma

Palabros:

etwas - algo
anderes - diferente | niemand anderes - nadie más
nie - nunca, jamás
niemals - nunca

Dativo:

mit - con
auf - en
zu(adverbio) - muy, demasiado
zu(preposición) - con, en, a
zur - al, a la 	
zum - a la, al, hacia el 
aus - de, desde, por
beim - en la, donde 
bei - junto, cerca
bei uns - a nuestra casa
am - en la, en el 
hinter - detrás

Personas:

freundin - amiga, novia
freund - amigo
person - persona
herr - señor, caballero (M)
dame - señora, dama
verein - asociación, club
verbindung - vínculo
leute - gente
französisch - francés 
mitglied - miembro (N)
mitgliedschaft - afiliación, membresía (F)
mannschaft - equipo
gegner - adversario
heimwerker - técnico del hogar, manitas
bürger - ciudadano
publikum - público
verhältnis - relación, proporción
bevölkerung - población
vorname - nombre de pila
gruppe - grupo
personal - (el) personal 
gast - huesped, cliente (M)
gemeinde - municipio, comunidad (F)
öffentlichkeit - pública
meinung - opinión
besucher - visitante
anfänger - novato
integration - integración (F)
käufer - comprador (M)
einwohner - habitante (M)
geschlecht - género, sexo (N)
erwachsene - adulto
englische - inglés
verbraucher, konsument, nutzer - consumidor, usuario (M)

Viajes: 

zug - tren (M)
pass - pasaporte(M)
wien - viena
österreich - autria
deutschland - alemania
boot - barco (N)
fahrzeug - vehículo (N)
sehenswürdigkeiten - atracciones turísticas (F)
reise - viaje (F)
fahrt - viaje (F)
motorrad - moto (N)
flug - vuelo (M)
frankreich - francia
weg - camino (M)
großbritannien - gran bretaña
stadtplan - mapa (M)
tourismus - turismo (M)
abenteuer - aventura (N)
spanien - españa
verkehr - tránsito, tráfico (M)
strecke - distancia (F)
mietwagen - coche de alquiler (M)
schweiz - suiza
bayern - baviera
bahn - via, tren (F)
ferien - vacaciones
besuch - visita
bushaltestelle - parada de autobuses (F)
ratgeber - consejero, guía (M)

Colores: farben

rot - rojo
blau - azul
grün - verde
gelb - amarillo
schwarz - negro

Profesión - Beruf (M)

richter - juez (M)
lehrer - maestro (M)
lehrerin - maestra (F)
arzt - doctor (M)
ärtzin - doctora (F)
schüler - alumno (M)
schülerin - alumna (F)
autor - autor (M)
händler - comerciante, vendedor (M)
senior - anciano (M)
meister - maestro (M)
trainer - entrenador (M)
student/in - estudiante
arbeitgeber/in - empleador/a
arbeit - empleo
geber - dador -> (geben - dar)
nehmer - tomador
professor - profesor
geschäftsführer - gerente (M)
geschäft - negocio
führer - líder
Leiter/in - jefe/a
architekt - arquitecto (M)
hersteller - productor, fabricante (M)
mitarbeiter - trabajador (M)
arbeitnehmer - trabajador (M)
bürgermeister - alcalde (M)
schneider - sastre (M)
bauer - agricultor (M)
fahrer - conductor (M)
rechtsanwalt - abogado (M)
recht - derecho
anwalt - defensa
teilnehmer - participante (M)
teil - parte
feuerwehrmann - bombero (M)
feuer - fuego
wehr - resistencia
feuerwehr - cuerpo de bomberos
verkäufer - vendedor (M)
was meinen - qué opinan
expert - experto
bedienung - servicio (F)
werkstatt - taller (F)
empfänger - destinatario (M)
verfasser - autor (M)
handwerk - artesanía (N)
betreiber - operador (M)
weber - tejedor (M)
koch - cocinero (M)
reiseführer - guía turístico
spezialität - especialidad
entwickler - desarrollador (M)


comparaciones:

groß - mayor, grande, gran
größere - el más grande
klein - menor, pequeño


calificadores:

gute - bueno
ziemlich - bastante
super - genial, fantástico, estupendo
sehr - muy, mucho
ganz - del todo, totalmente, completamente
gewöhnlich - siempre, usualmente, común
beste - mejor
bessere - el mejor
eher - mas bien

preposiciones:

Aclaración: En el caso de las Wechselpräpositionen si se indica dirección de movimiento se usa caso acusativo, si indica ubicación dativo. an, auf, hinter, in, neben, über, unter, vor, zwischen

für - para
in - en
an - encendida, de	-> was magst du an ihr? "Qué te gusta de ella?"
im (in dem) - en el
ins (in das) - a la
über - acerca de, sobre, de (about)
ohne - sin
seit - desde
ab - desde, a partir de
zwischen - entre
um - a las	mein flug ist um sechs
ums (um das) - alrededor, en torno a
bis - hasta
durch - a través, por
gegen - contra
während - durante, mientras
vor - delante de, hace, antes de
von - de
vom (von + dem) - del
vorm (vor + dem) - por delante de la
ab und zu - de vez en cuando
außer - menos, excepto, a excepción de
neben - junto, al lado
wegen - a causa de, debido a, por causa
unter - debajo de, entre
hinter - detrás de, tras, detrás
einschließlich - incluido, inclusive, incluyendo
trotz - a pesar de
gegenüber - delante de, enfrente de, enfrente
extra - expresamente, especialmente, extra


adjetivos predicativos: 

fit - en forma
kaputt - roto, estropeado
komplett - completamente
herzlich - cordial, afectuosa, cariñosa
automatisch - automático
echt - de verdad, real, auténtico
erneut - nuevo
müde - cansado
relativ - relativo
international - internacional
eindeutig - obvio, inequívoco, indiscutible, indudable
selbstverständlich - evidente, lógico, obvio
selbst - por sí mismo 
verständ - comprensible
schöner - más bonito
regional - regional, local
wesentlich - esencial, fundamental
täglich - diariamente, a diario
jährlich - anualmente, al año
kürzlich - recientemente, hace poco
ruhig - tranquilo
leichter - más fácil, más liviano, más ligero
begeister - entusiasmado, impresionado
beliebt - apreciada, popular
verpflichtet - comprometido, obligado
original - original
persönlich - personal
plötzlich - de pronto, repentino -> plötzlich sehe ich dich - de pronto te veo
völlig - todo
fertig - cansado, rendido
jung - joven
zufrieden - contento, satisfecho
verfügbar - disponible
aktiv - activo
leicht - ligero
abhängig - adicto, dependiente
unabhängig - independiente	
knapp - escasa, justa
privat - en privado
stärker - más fuertes
bereit - listos
höher - más alto
wirklich - de verdad, realmente
allgemein - general/mente, común
individuell - individual
tatsächlich - efectivamente
verantwortlich, zuständig - responsable
länger - más largo
falsch - malo, falso
ausgezeichnet - excelente, magnífico
sinnvoll - sensato
sichtvar - visible
ähnlich - similar, parecida, semejante
notwendig - necesaria
extrem - extremadamente, extremo
offen - abierto
deutlich - claro, claramente
hilfreich - útil, beneficioso
unbekannt - desconocido
egal - da lo mismo, igual, no importa
wert - vale (valer)

Presente 2(verbos):

separables:
 
zumachen - cerrar - ich mache die tür zu - yo cierro la puerta
anmachen - encender
aufmachen - abrir
aufstehen - levantarse	-- levantar el autoestima
eintreffen - llegar
aussehen - parecer
aufräumen - limpiar
aussteigen - bajar, salir	-- dónde estáis gente? ya bajamos
aufsteigen - subir, montar
anhalten - detener, parar
aufhalten - retener
festhalten - agarrar, detener
untergehen - hundirse ** gehen wir unter -- nos hundimos
ausgehen - salir
aufhören - detener, terminar, acabar	** sie hört sie auf - ella la detiene
hören auf - hacer caso ** sie hört auf sie - ella le hace caso  // La posición de auf muestra si es preposición o partícula separable
vorstellen - presentar
einsammeln - recoger


------------------

leben - vivir
wohnen - vivir
kochen - cocinar
arbeiten - trabajar
passieren - pasar, suceder, ocurrir
machen - hacer
erlauben - permitir	-- allowing
finden - encontrar	-- finding
treffen - encontrar
suchen - buscar, rastrear	-- busca su hucha
kommen - venir	-- coming
fahren - viajar
reisen - viajar
gefallen - gustar	-- me gusta el fallout
ändern - cambiar, modificar	-- ande a cambiarse
reden - hablar	-- hablar con una red en la cara
funktionieren - funcionar
hören - oír, escuchar	-- en orán oirás cuando oren
geben - dar	-- giving
schwimmen - nadar	-- swimming
sammeln - reunir, recoger, coleccionar	-- pásame el recogedor
benutzen - usar, utilizar	-- Ven, usa la venus de USA
scheinen - brillar, parecer	-- shining
ersetzen - reemplazar, sustituir	-- sustituix el setze	** se usa con durch 
verkaufen - vender
verbrauchen - consumir
warten - esperar -> ich warte auf meine Freunde - yo espero a mis amigos
hoffen - esperar, confiar -> ich hoffe, dass ich bald Millionär wäre - espero pronto ser millonario
stellen - poner, colocar	-- pon la tele
stehlen - robar -- stealing
möchten - gusta
schließen - cerrar		-- schhh, listen (door closing sound)
bestellen - pedir		-- voy a pedir mientras ves la tele
zeigen - enseñar, mostrar, transmitir	-- salgan que os voy a enseñar la muestra
übernehmen - hacerse cargo de, tomar las riendas	-- a ver, anímense, tomen las riendas del caballo y háganse cargo
nehmen - tomar, coger	-- anímense, cojan una pastilla, tomen unas copas
meinen - pensar, opinar
prüfen - revisar, controlar, probar	  	-- prueba la trufa -- proof
bleiben - quedarse, quedar		-- blas ven! neimar se queda
erkennen - reconocer	(kennen -> conocer, erkennen - re conocer)
spazieren - pasear	-- es pasetjen
halten - sostener, aguantar	-- alto! anguanta, sostente con fuerza para no caerte
abonnieren - suscribir, abonar
subskribieren - suscribirse
liegen - estar ubicado, estar tendido  -- es tan bueno que liga tumbado -- laying
erweitern - alargar, dilatar, ampliar, extender	-- el bait que me has pegao ha alargado la partida
singen - cantar -- singing
fehlen - faltar, echar de menos
glauben - creer, opinar	-- creo que sánchez no es cum laude
der glaube - la fe	** ich glaube an dich Jesus
akzeptieren - aceptar -- accepting
kosten - costar, valer
sie hört auf sie - le hace caso
gehen unter - hundirse
stehen - encontrarse, levantarse, estar de pie

medicina:

der patient - el paciente
krank - enfermo
die krankheit - la enfermedad
die krankenversicherung - el seguro de enfermedad
das krankenhaus - el hospital
der krankenwagen - la ambulancia
das bein - la pierna
die beine - las piernas
der Fuß - el pie
die füße - los pies
die hand - la mano
der körper - el cuerpo
das auge - el ojo
die therapie - la terapia
das herz - el corazón
die praxis - el consultorio
die gesundheit - la salud
das medikament - el medicamento
die medizin - la medicina
der unfall - el accidente
der hals - el cuello
das blut - la sangre
die haare - el pelo ** magst du meine Haare? - te gusta mi pelo?
das haar - el pelo ** ich zieh ein Haar - me arranco un pelo
das opfer - la víctima
das gesicht - la cara
die untersuchung - el examen, análisis, chequeo
der finger - el dedo
die haut - la piel
das formular - el formulario
die geburt - el nacimiento, parto
die sucht - la adicción
der alkohol - el alcohol
die diät - la dieta
die klinik - la clínica
der kopf - la cabeza
die pflege - el cuidado, la asistencia
der notfall - la emergencia
die ernährung - la alimentación


nuevos palabros:

vielleicht - quizás
ich heiße - me llamo
wie heißen sie? - cómo se llama? formal
wie ist ihr name? - cuál es su nombre? formal
wie ist dein name? - cuál es tu nombre? informal
wie heißt du? - cómo te llamas? informal
wie heißt ihr? - cómo os llamais? informal
guten tag - buen día
guten morgen - buenos días
guten abend - buenas tardes
ich komme aus - vengo de
ich wohne in - vivo en
die ratte - la rata
rechts - derechos
die nachrichten - las noticias
geradeus - recto
die bäckerei - la panadería
der druck - la presión
draußen - fuera
der preis - el precio
die freiheit - la libertad
die sprache - el lenguaje
der schrank - el armario
schreien - gritar
kritisieren - criticar
prima - bien
das problem - el problema
erklären - explicar
verlieren - perder
studieren - estudiar
erwarten - esperar
die wahrheit - la verdad
gefährlich - peligroso
hier - aquí
das wetter - el tiempo
der sommer - el verano
der politiker - el político
das meer - el océano
das fußballspieler - el futbolista
der sport - el deporte
der berg - la montaña
dort - allí
er lernt viel - él estudia mucho
die prüfung - el examen
gerade - ahora
lärm - ruido
lernen - estudiar, aprender
überstunden - horas extra
pause - descanso
apotheke (apoteca) - farmacia
das fenster ist auf - la ventana está abierta
die tür ist zu - la puerta está cerrada
computer - computadora
die lampe ist aus - la lámpara está apagada
oben - arriba -> maria ist oben
unten - debajo -> klaus ist unten
da - allí -> ist klaus da?
der külhschrank - el frigorífico
der karton ist leer - la caja está vacía
die kinder sind weg - los niños se han ido
die treppe ist da hinten - las escaleras están allí detrás
der aufzug ist da vorne - el ascensor está ahí enfrente
der junge ist drinnen - el niño está dentro
das mädchen ist draußen - la niña está fuera
auch - también

alfabeto:

A-A
B-B
C-Se
D-D
E-E
F-Ef
G-Gue
H-Ja
I-I
J-Yot
K-K
L-El
M-Em
N-En
O-O
P-P
Q-Q
R-Er
S-Es
T-Ti
U-U
V-Fau
W-B
X-Ix
Y-Ypsilon/Üpsilon
Z-tset


misc: 

ir a + infinitivo
	du gehst schlafen - tú vas a dormir

La primer parte de la oración "Hauptsatz" (oración principal) se escribe siempre normalmente. Pero la segunda parte "Nebensatz" (oración subordinada) no tiene la escritura común, sino que en alemán, al haber una Nebensatz el verbo conjugado pasa automáticamente AL FINAL de la oración. Entonces, la estructura de la Nebensatz sería: 1pos - conjunción (obwohl); 2pos - sujeto (wir); 3pos - complemento directo (müde); 4pos - complemento indirecto (en este caso no hay); última posición - verbo conjugado.

Las oraciones subordinadas no pueden existir sin una oración principal y tienen siempre el verbo al final. 
	wenn du müde bist, warum gehst du nichst schlafen? - Si estás cansado, por qué no vas a dormir?
	
Se trata de la partícula "zu" del verbo separable "zumachen" (cerrar), ( trennbare Verben). Al conjugar el verbo, se separa la partícula y se la coloca al finalizar la oración.

wen es la forma acusativa de wer y wem la forma dativa -> auf wen, mit wem

https://yourdailygerman.com/moegen-gern-gefallen-difference/

Si la acción implica movimiento no es dativo, por ejemplo, ich stelle die flasche auf den tisch - pongo la botella en la mesa, si la botella estuviera en la mesa sería dativo.

pronunciación r:

https://www.youtube.com/watch?v=fLNPsFOnTWI&index=4&list=PL5QyCnFPRx0GxaFjdAVkx7K9TfEklY4sg